________________________________________________________________________________________________________________________________________________________________________________________________________1___________________________________________________________
__0102030405060708091011121314151617181920212223242526272829303132333435363738394041424344454647484950515253545556575859606162636465666768697071727374757677787980818283848586878889909192939495969798990001020304050607080910111213141516171819202122232425262728__
64................................................................................................................................................................................................................................................................64
63##01########################......................##########################################################........############################################............................................................######..............................63
62##01##########################..................############################################################........############################################............................................................########............................62
61##01############################................############################################################......################################################..........................................................############........................61
60##01##############################............##############################################################....##################################################........................................................##################..............##01##60
59##01########################################################################################################..######################################################....................................................######################....##########01##59
58##01################################################################################################################################################################....................................................####################################01##58
57##01##################################################################################################################################################################..............................####..####......########################################01##57
56##01##################################################################################################################################################################............................##############..################..########################01##56
55##01####################################################################################################################################################################........................################..################..########################01##55
54##01####################################################################################################################################################################..................######################..################..########################01##54
53##01####################################################################################################################################################################..................########################################..########################01##53
52##01####################################################################################################################################################################..................########################################..########################01##52
51##01####################################################################################################################################################################..................########################################..########################01##51
50##01####################################################################################################################################################################..................########################################..########################01##50
49##01######################################################################################################################################################################..............######################################......########################01##49
48##01######################################################################################################################################################################..............##################################..####....########################01##48
47##01######################################################################################################################################################################..............########################################..##########################01##47
46##01######################################################################################################################################################################................######################################..##########################01##46
45##01######################################################################################################################################################################..................####################################..##########################01##45
44##01######################################################################################################################################################################..................##################################..############################01##44
43##01########################################################################################################################################################################..................################################..############################01##43
42##01########################################################################################################################################################################..................##############################..##############################01##42
41##01########################################################################################################################################################################....................##########################..################################01##41
40##01##########################################################################################################################################################################..................########################..##################################01##40
39##01##########################################################################################################################################################################..................########....####....########################################01##39
38##01##########################################################################################################################################################################..................############################################################01##38
37##01##########################################################################################################################################################################..................############################################################01##37
36##01##########################################################################################################################################################################....................##########################################################01##36
35##01##########################################################################################################################################################################....................##########################################################01##35
34##01##########################################################################################################################################################################....................##########################################################01##34
33##01##########################################################################################################################################################################........................######################################################01##33
32##01##########################################################################################################################################################################........................######################################################01##32
31##01##########################################################################################################################################################################........................######################################################01##31
30##01##########################################################################################################################################################################........................######################################################01##30
29##01########################################################################################################################################################################..........................######################################################01##29
28##01########################################################################################################################################################################........................########################################################01##28
27##01##########################################################################################################################################################################......................########################################################01##27
26##01##########################################################################################################################################################################......................########################################################01##26
25##01##########################################################################################################################################################################......................########################################################01##25
24##01##########################################################################################################################################################################......................########################################################01##24
23##01##########################################################################################################################################################################......................########################################################01##23
22##01########################################################################################################################################################################............................####################################################01##22
21##01################################################################################################################################################################....................................####################################################01##21
20##01################################################################################################################################################################....................................####################################################01##20
19##01################################################################################################################################################################....############....................####################################################01##19
18##01##################################################################################################################################################################################..................####################################################01##18
17##01##################################################################################################################################################################################................######################################################01##17
16##01##################################################################################################################################################################################..########..##########################################################01##16
15##01##################################################################################################################################################################################..####################################################################01##15
14##01##################################################################################################################################################################################..####################################################################01##14
13##01########################################################################################################################################################################################################################################################01##13
12##01########################################################################################################################################################################################################################################################01##12
11##01########################################################################################################################################################################################################################################################01##11
10##01########################################################################################################################################################################################################################################################01##10
_9##01########################################################################################################################################################################################################################################################01##_9
_8##01########################################################################################################################################################################################################################################################01##_8
_7##01########################################################################################################################################################################################################################################################01##_7
_6##01########################################################################################################################################################################################################################################################01##_6
_5##01########################################################################################################################################################################################################################################################01##_5
_4##01########################################################################################################################################################################################################################################################01##_4
_3##01########################################################################################################################################################################################################################################################01##_3
_2####01010101010101010101010101010101010101010101010101010101010101010101010101010101010101010101010101010101010101010101010101010101010101010101010101010101010101010101010101010101010101010101010101010101010101010101010101010101010101010101010101010101####_2
_1################################################################################################################################################################################################################################################################_1
__0102030405060708091011121314151617181920212223242526272829303132333435363738394041424344454647484950515253545556575859606162636465666768697071727374757677787980818283848586878889909192939495969798990001020304050607080910111213141516171819202122232425262728__
________________________________________________________________________________________________________________________________________________________________________________________________________1___________________________________________________________
