________________________________________________________________________________________________________________________________________________________________________________________________________1___________________________________________________________
__0102030405060708091011121314151617181920212223242526272829303132333435363738394041424344454647484950515253545556575859606162636465666768697071727374757677787980818283848586878889909192939495969798990001020304050607080910111213141516171819202122232425262728__
64................................................................................................................................................................................................................................................................64
630101########################......................##########################################################........############################################............................................................######..............................63
620101##########################..................############################################################........############################################............................................................########............................62
610101############################................############################################################......################################################..........................................................############........................61
600101##############################............##############################################################....##################################################........................................................##################..............##010160
590101########################################################################################################..######################################################....................................................######################....##########010159
580101################################################################################################################################################################....................................................####################################010158
570101##################################################################################################################################################################..............................####..####......########################################010157
560101##################################################################################################################################################################............................##############..################..########################010156
550101####################################################################################################################################################################........................################..################..########################010155
540101####################################################################################################################################################################..................######################..################..########################010154
530101####################################################################################################################################################################..................########################################..########################010153
520101####################################################################################################################################################################..................########################################..########################010152
510101####################################################################################################################################################################..................########################################..########################010151
500101####################################################################################################################################################################..................########################################..########################010150
490101######################################################################################################################################################################..............######################################......########################010149
480101######################################################################################################################################################################..............##################################..####....########################010148
470101######################################################################################################################################################################..............########################################..##########################010147
460101######################################################################################################################################################################................######################################..##########################010146
450101######################################################################################################################################################################..................####################################..##########################010145
440101######################################################################################################################################################################..................##################################..############################010144
430101########################################################################################################################################################################..................################################..############################010143
420101########################################################################################################################################################################..................##############################..##############################010142
410101########################################################################################################################################################################....................##########################..################################010141
400101##########################################################################################################################################################################..................########################..##################################010140
390101##########################################################################################################################################################################..................########....####....########################################010139
380101##########################################################################################################################################################################..................############################################################010138
370101##########################################################################################################################################################################..................############################################################010137
360101##########################################################################################################################################################################....................##########################################################010136
350101##########################################################################################################################################################################....................##########################################################010135
340101##########################################################################################################################################################################....................##########################################################010134
330101##########################################################################################################################################################################........................######################################################010133
320101##########################################################################################################################################################################........................######################################################010132
310101##########################################################################################################################################################################........................######################################################010131
300101##########################################################################################################################################################################........................######################################################010130
290101########################################################################################################################################################################..........................######################################################010129
280101########################################################################################################################################################################........................########################################################010128
270101##########################################################################################################################################################################......................########################################################010127
260101##########################################################################################################################################################################......................########################################################010126
250101##########################################################################################################################################################################......................########################################################010125
240101##########################################################################################################################################################################......................########################################################010124
230101##########################################################################################################################################################################......................########################################################010123
220101########################################################################################################################################################################............................####################################################010122
210101################################################################################################################################################################....................................####################################################010121
200101################################################################################################################################################################....................................####################################################010120
190101################################################################################################################################################################....############....................####################################################010119
180101##################################################################################################################################################################################..................####################################################010118
170101##################################################################################################################################################################################................######################################################010117
160101##################################################################################################################################################################################..########..##########################################################010116
150101##################################################################################################################################################################################..####################################################################010115
140101##################################################################################################################################################################################..####################################################################010114
130101########################################################################################################################################################################################################################################################010113
120101########################################################################################################################################################################################################################################################010112
110101########################################################################################################################################################################################################################################################010111
100101########################################################################################################################################################################################################################################################010110
_90101########################################################################################################################################################################################################################################################0101_9
_80101########################################################################################################################################################################################################################################################0101_8
_70101########################################################################################################################################################################################################################################################0101_7
_60101########################################################################################################################################################################################################################################################0101_6
_50101########################################################################################################################################################################################################################################################0101_5
_40101########################################################################################################################################################################################################################################################0101_4
_30101########################################################################################################################################################################################################################################################0101_3
_20101010101010101010101010101010101010101010101010101010101010101010101010101010101010101010101010101010101010101010101010101010101010101010101010101010101010101010101010101010101010101010101010101010101010101010101010101010101010101010101010101010101010101_2
_10101010101010101010101010101010101010101010101010101010101010101010101010101010101010101010101010101010101010101010101010101010101010101010101010101010101010101010101010101010101010101010101010101010101010101010101010101010101010101010101010101010101010101_1
__0102030405060708091011121314151617181920212223242526272829303132333435363738394041424344454647484950515253545556575859606162636465666768697071727374757677787980818283848586878889909192939495969798990001020304050607080910111213141516171819202122232425262728__
________________________________________________________________________________________________________________________________________________________________________________________________________1___________________________________________________________
