________________________________________________________________________________________________________________________________________________________________________________________________________1___________________________________________________________
__0102030405060708091011121314151617181920212223242526272829303132333435363738394041424344454647484950515253545556575859606162636465666768697071727374757677787980818283848586878889909192939495969798990001020304050607080910111213141516171819202122232425262728__
64................................................................................................................................................................................................................................................................64
63############################......................##########################################################........############################################............................................................######..............................63
62##############################..................############################################################........############################################............................................................########............................62
61################################................############################################################......################################################..........................................................############........................61
60##################################............##############################################################....##################################################........................................................##################..............######60
59############################################################################################################..######################################################....................................................######################....##############59
58####################################################################################################################################################################....................................................########################################58
57######################################################################################################################################################################..............................####..####......############################################57
56######################################################################################################################################################################............................##############..################..############################56
55########################################################################################################################################################################........................################..################..############################55
54########################################################################################################################################################################..................######################..################..############################54
53########################################################################################################################################################################..................########################################..############################53
52########################################################################################################################################################################..................########################################..############################52
51########################################################################################################################################################################..................########################################..############################51
50########################################################################################################################################################################..................########################################..############################50
49##########################################################################################################################################################################..............######################################......############################49
48##########################################################################################################################################################################..............##################################..####....############################48
47##########################################################################################################################################################################..............########################################..##############################47
46##########################################################################################################################################################################................######################################..##############################46
45##########################################################################################################################################################################..................####################################..##############################45
44##########################################################################################################################################################################..................##################################..################################44
43############################################################################################################################################################################..................################################..################################43
42############################################################################################################################################################################..................##############################..##################################42
41############################################################################################################################################################################....................##########################..####################################41
40##############################################################################################################################################################################..................########################..######################################40
39##############################################################################################################################################################################..................########....####....############################################39
38##############################################################################################################################################################################..................################################################################38
37##############################################################################################################################################################################..................################################################################37
36##############################################################################################################################################################################....................##############################################################36
35##############################################################################################################################################################################....................##############################################################35
34##############################################################################################################################################################################....................##############################################################34
33##############################################################################################################################################################################........................##########################################################33
32##############################################################################################################################################################################........................##########################################################32
31##############################################################################################################################################################################........................##########################################################31
30##############################################################################################################################################################################........................##########################################################30
29############################################################################################################################################################################..........................##########################################################29
28############################################################################################################################################################################........................############################################################28
27##############################################################################################################################################################################......................############################################################27
26##############################################################################################################################################################################......................############################################################26
25##############################################################################################################################################################################......................############################################################25
24##############################################################################################################################################################################......................############################################################24
23##############################################################################################################################################################################......................############################################################23
22############################################################################################################################################################################............................########################################################22
21####################################################################################################################################################################....................................########################################################21
20####################################################################################################################################################################....................................########################################################20
19####################################################################################################################################################################....############....................########################################################19
18######################################################################################################################################################################################..................########################################################18
17######################################################################################################################################################################################................##########################################################17
16######################################################################################################################################################################################..########..##############################################################16
15######################################################################################################################################################################################..########################################################################15
14######################################################################################################################################################################################..########################################################################14
13################################################################################################################################################################################################################################################################13
12################################################################################################################################################################################################################################################################12
11################################################################################################################################################################################################################################################################11
10################################################################################################################################################################################################################################################################10
_9################################################################################################################################################################################################################################################################_9
_8################################################################################################################################################################################################################################################################_8
_7################################################################################################################################################################################################################################################################_7
_6################################################################################################################################################################################################################################################################_6
_5################################################################################################################################################################################################################################################################_5
_4################################################################################################################################################################################################################################################################_4
_3################################################################################################################################################################################################################################################################_3
_2################################################################################################################################################################################################################################################################_2
_1################################################################################################################################################################################################################################################################_1
__0102030405060708091011121314151617181920212223242526272829303132333435363738394041424344454647484950515253545556575859606162636465666768697071727374757677787980818283848586878889909192939495969798990001020304050607080910111213141516171819202122232425262728__
________________________________________________________________________________________________________________________________________________________________________________________________________1___________________________________________________________
